#
 [==]  [=]
    |  {=}
    ||   
    >    _  ______
    >    |  <####>
    >    |  <####>
    <    |  <####>
    <    -  <####>
    <       ------