#
 [==]  [=]
    |  {=}   l
    ||      r
    >  _ ______
    >  | <l##r>
    >  | <l##r>
    <  | <l##r>
    <  - <l##r>
    <    ------